#include <ncurses/ncurses.h>

level 1
"#################################",
"#...............................E",
"#...#####################...#####",
"#...........#...........#.......#",
"#########...#...#############...#",
"#.......#...#...#...............#",
"#####...#...#...#...#...#########",
"#.......#...#...#...#...........#",
"#...#####...#...#############...#",
"#...#.......#...#...........#...#",
"#...#...#####...#...#####...#...#",
"#.......#.......#...#.......#...#",
"#########...#####...#...#####...#",
"#...........#.......#...#.......#",
"#...#############...#...#####...#",
"S...................#...........#",
"#################################"
